00000000000000000000
00000000000000000000
00111000110000111111
00000000000000000000
00000000000000000000
11110000000000011100
00000000000000000000
00000000000000000000
00000001111111000000
00000000000000000000